wwwwwwwwwwwwwww
w000000w0ww0w0w
w0ww0w000w0000w
w00wwwww000wwww
w00w00000www00w
ww0w0ww0ww000ww
w00www00000wwww
ww00www0w0ww00w
www0w000w0000ww
www00wwww0wwwww
www0ww0w00ww00w
w000w00w0ww00ww
w0www0w00000www
w0ww00ww0ww000G
wwwwwwwwwwwwwww
